wwwwwwwwwww
wp-ww-ww-&w
w--w-w-w--w
w----w----w
w---w-w---w
w--w-w-w--w
w--w---w--w
w--wwwww--w
w----w----w
w----w----w
w--wwwww--w
w----w----w
w----w----w
w---------w
w---------w
wwwwwwwwwww